2-----30002-----------300000
|.....|000|...........|00000
|.000.1---4.2-------3.|00000
|.000.......|0000000|.1----3
|......2----40000000|......|
1----3.|-------30000|.0000.|
00000|.|.......1----4.0000.|
-----4.|.2---3.............|
f......|.|0001-------------4
2------4.1------30002------3
|...............1---4......|
|.000000.2----3.......0000.|
|.000000.|0000|.000-------.|
|.000000.|0000|.000.....|0.|
|........|0000|.........|0@|
1--------400001---------1--4